NO ./path_to_the_north_texture
SO ./path_to_the_south_texture
WE ./path_to_the_west_texture
EA ./path_to_the_east_texture

F 220,100,0
C 225,30,0

        1111111111111111111111111\n
        1000000000110000000000001\n
        1011000001110000001000001\n
        1001000000000000000000001\n
111111111011000001110000000000001\n
100000000011000001110111111111111\n
11110111111111011100000010001\n
-1-1-1-1-1-1-1-1-1-1\n
\n
11110111111111011101010010001\n
11000000110101011100000010001\n
10001000000000001100000010001\n
10000000000000001101010010001\n
11000001110101011111011110N0111\n
11110111 1110101 101111010001\n
11111111 1111111 111111111111\0

./cub3D .cub